xxxxxxxxxxxxxxxxxxx
x1x1#1#1#1#1#1#1x1x
x0xx1x.x1x1x.x1xx0x
x#11#1#1#.#1#1#11#x
x1xx.xxxxxxxxx.xx1x
x#11#.#1#.#1#.#11#x
xxxx1x.x.x.x.x1xxxx
...x1x4.444.4x1x...
xxxx1x.xx"xx.x1xxxx
....#.4x f x4.#....
xxxx1x.xxxxx.x1xxxx
...x1x4.1x1.4x1x...
xxxx1x.xxxxx.x1xxxx
x#11#.4.4x4.4.#11#x
x1xx1xxx1x1xxx1xx1x
x$#1#1#1#p#1#1#1#$x
xx1xxx1xx1xx1xxx1xx
x##x1x#1#1#1#x1x##x
x1xx.x1x1x1x1x.xx1x
x#11#1#1#1#1#1#11#x
xxxxxxxxxxxxxxxxxxx