xxxxxxxxxxxxxxxxxxx
x0x1x1x1x1x1x1x1x0x
x1x1x#.#x1x#.#x1x1x
x1x1x1x1x1x1x1x1x1x
x1x1x1x1x1x1x1x1x1x
x#4#4#4#4#4#4#4#4#x
xx.x1x.x.x.x.x1x.xx
.x.x1x4.444.4x1x.x.
xx.x1x.xx"xx.x1x.xx
..#.#.4x f x4.#.#..
xx.x1x.xxxxx.x1x.xx
.x.x1x4.1x1.4x1x.x.
xx.x1x.xxxxx.x1x.xx
x#11#.4.4x4.4.#11#x
x1xx1xxx1x1xxx1xx1x
x$#1#1#1#p#1#1#1#$x
xx1x.xxx.xxx.xxx1xx
x1#x1x1x1x1x1x1x#1x
xx1xxx.xxx.xxx.x1xx
x.4111#1.1#1.1414.x
xxxxxxxxxxxxxxxxxxx